044444444428341
566666666666665
560444444444445
565666666656665
565604464444165
565656666666565
565656044446565
565656566666665
565656565644445
566656565666665
565656565444465
565656565656665
344444265634445
766666666666665
444444444444442